Chapter30.txt	神樂觀、莫愁湖、金陵、建康、應天、神樂觀、花牌樓、神樂觀、報恩寺、河房、莫愁湖、莫愁湖、莫愁湖、水西門、水西門、淮清橋
Chapter31.txt	南京
Chapter32.txt	金陵
Chapter33.txt	倉巷、狀元境、淮清橋、東水關、倉巷、龍江關、河房、南京、清涼山、靈隱觀、金陵
Chapter34.txt	金陵、淮清橋、南京、三山街、三山二水、南京、南京
Chapter35.txt	白門、金陵、元武湖、燕子磯、漢西門、元武湖、臺城、雞鳴寺、清涼山
Chapter36.txt	南京、金陵、元武湖、元武湖、金陵、南京
Chapter37.txt	南京、南門、金陵、江寧
Chapter38.txt	江南、南京、太平府、蕪湖縣
Chapter39.txt	無
Chapter40.txt	廣武山、利涉橋、江南、應天府、白門、京城、花牌樓、缺口門、河下、金陵
Chapter41.txt	秦淮河、秦淮、文德橋、利涉橋、東水關、進香河、王府塘、手帕巷、金陵、金陵、金陵、建康、江寧、金陵、南京大邦、王府塘、手帕巷、水西門
Chapter42.txt	金陵、釣魚巷、鷲峰寺
Chapter43.txt	漢西門
Chapter44.txt	儀徵、金陵、利涉橋、孝陵、下浮橋、施家巷
Chapter45.txt	金陵、南京、金陵、金陵
Chapter46.txt	三山門、金陵、後湖、金陵
Chapter47.txt	元武閣
Chapter48.txt	金陵、金陵、建康、江寧、白下、上江、金陵
Chapter49.txt	鳳凰池
Chapter50.txt	洪武街、江寧
